XXXXXXXXXXXXXXXXXXXXXXXXXXXXXXXXXXXXXXXXXXXXXXX
X##                                         ##X
X#X X X X X X X X X X X X X X X X X X X X X X#X
X                                             X
X X X X X X X X X X X X X X X X X X X X X X X X
X                                             X
X X X X X X X X X X X X X X X X X X X X X X X X
X                                             X
X X X X X X X X X X X X X X X X X X X X X X X X
X                                             X
X X X X X X X X X X X X X X X X X X X X X X X X
X                                             X
X X X X X X X X X X X X X X X X X X X X X X X X
X                                             X
X X X X X X X X X X X X X X X X X X X X X X X X
X                                             X
X X X X X X X X X X X X X X X X X X X X X X X X
X                                             X
X X X X X X X X X X X X X X X X X X X X X X X X
X                                             X
X X X X X X X X X X X X X X X X X X X X X X X X
X                                             X
X X X X X X X X X X X X X X X X X X X X X X X X
X                                             X
X X X X X X X X X X X X X X X X X X X X X X X X
X                                             X
X X X X X X X X X X X X X X X X X X X X X X X X
X                                             X
X X X X X X X X X X X X X X X X X X X X X X X X
X                                             X
X X X X X X X X X X X X X X X X X X X X X X X X
X                                             X
X X X X X X X X X X X X X X X X X X X X X X X X
X                                             X
X X X X X X X X X X X X X X X X X X X X X X X X
X                                             X
X X X X X X X X X X X X X X X X X X X X X X X X
X                                             X
X X X X X X X X X X X X X X X X X X X X X X X X
X                                             X
X X X X X X X X X X X X X X X X X X X X X X X X
X                                             X
X X X X X X X X X X X X X X X X X X X X X X X X
X                                             X
X#X X X X X X X X X X X X X X X X X X X X X X#X
X##                                         ##X
XXXXXXXXXXXXXXXXXXXXXXXXXXXXXXXXXXXXXXXXXXXXXXX